%%%%%%%%%%%%%%%%%%%%%%%%%%%%%%%%%%%%%%%
%.....%...%.%...%.%.......%...........%
%%%.%.%.%%%.%%%.%.%%%%%%%.%%%%%.%.%%%.%
%.%.%.%.....%...........%.%.%...%.%...%
%.%.%.%.%%%%%%%.%%%%%%%.%.%.%.%%%.%.%%%
%.%.%.......%.%.%.....%.%.%...%...%...%
%.%.%.%%%%%%%.%.%.%%%.%%%.%%%.%.%.%%%%%
%...%.......%...%...%...%.%.%.%.%.....%
%%%.%%%.%%%%%.%%%.%%%%%%%.%.%.%%%.%.%%%
%.%.%...........%.%.%.....%.......%...%
%.%.%%%.%%%%%.%%%.%.%%%.%%%.%%%.%.%%%.%
%.%.%...%.%...%.....%.......%.%.%.%...%
%.%.%%%.%.%.%.%.%.%%%%%%%%%%%.%.%%%%%.%
%.........%.%...%.%.%...%...%...%.....%
%%%.%%%%%%%.%%%%%.%.%.%%%%%.%.%%%.%%%.%
%.........%.....%...%...%...%.....%.%.%
%%%%%.%.%.%%%.%%%%%%%%%.%.%%%.%.%%%.%.%
%.%.%.%.%.........%.%.........%...%.%.%
%.%.%.%.%%%%%%%.%%%.%.%%%%%%%.%%%.%.%.%
%.....%.%.%...%...%.%.%.%.%...%...%.%.%
%%%%%%%.%.%%%%%.%%%.%%%.%.%.%%%.%.%.%%%
%.%.%.......%.%.....%.%.....%.%.%...%.%
%.%.%%%.%%%%%.%.%.%%%.%.%%%%%.%%%%%.%.%
%...........%...%.%.......%.%.........%
%%%.%%%%%%%%%%%.%.%%%%%.%%%.%%%.%%%%%%%
%.%.....%.....%.%.%.....%.....%.%.%...%
%.%%%.%%%.%%%%%.%%%.%.%%%.%%%.%.%.%.%%%
%.%.......%...%...%.%.%.%...%.....%...%
%.%%%%%%%.%%%.%.%%%.%.%.%%%%%%%.%%%%%.%
%.....%.%.%.....%...%.%.......%.%.....%
%%%%%.%.%%%.%%%.%.%%%.%%%.%%%.%.%%%%%.%
%.......%...%.......%.....%.........%.%
%.%.%%%.%.%.%%%%%.%%%.%%%%%%%%%.%%%.%.%
%.%...%.%.%...%.%...%.....%.....%.%.%.%
%.%%%%%.%%%%%%%.%.%.%%%.%.%.%.%.%.%%%.%
%...%.%.%...%...%.%.%...%.%.%.%...%...%
%.%%%.%.%.%.%.%.%.%%%%%.%%%.%.%%%%%.%.%
%...%.....%...%.......%...%.%.....%.%.%
%%%%%%%%%%%%%%%%%%%%%%%%%%%%%%%%%%%%%%%
