%%%%%%%%%%%%%%%%%%%%%%%%%%%%%%%%%%%%%%%
%.....%...%.%...%.%.......%...........%
%%%%%.%.%%%.%%%.%.%%%%%%%.%%%%%.%.%%%.%
%.%...%.....%...........%.%.%...%.%...%
%.%.%.%.%%%%%%%.%%%%%%%.%.%.%.%%%.%.%%%
%.%.%.......%.%.%.....%.%.%...%...%...%
%.%.%.%%%%%%%.%.%.%%%.%%%.%%%.%.%.%%%%%
%...%.......%...%...%...%.%.%.%.%.....%
%%%.%%%.%%%%%.%%%.%%%%%%%.%.%%%%%.%.%%%
%.%.%...........%.%.%.....%.....%.%...%
%.%%%%%.%%%%%.%%%.%.%%%.%%%.%%%.%.%%%.%
%.%.%.....%...%.....%.......%.%.%.%...%
%.%.%%%.%.%.%.%.%.%%%%%%%%%%%.%.%%%%%.%
%.........%.%...%.%.%...%...%...%.....%
%%%.%%%%%%%.%%%%%.%.%.%%%%%.%.%%%.%%%.%
%.........%.....%...%...%...%.....%.%.%
%%%%%.%.%.%%%.%%%%%%%%%.%.%%%.%.%%%.%.%
%.%.%.%.%.........%.%.........%...%.%.%
%.%.%.%%%%%%%.%.%%%.%.%%%%%%%.%%%.%.%.%
%.....%.%.%...%...%.%.%.%.%...%...%.%.%
%%%%%.%%%%%%%%%.%%%.%%%.%.%.%%%.%.%.%%%
%...........%.%.....%.%.....%.%.%...%.%
%.%%%%%%%%%.%.%.%.%%%.%.%%%%%.%%%%%.%.%
%.%%%%%%%%%.%...%.%.......%.%.........%
%.%%%%%%%%%.%%%.%.%%%%%.%%%.%%%.%%%.%%%
%...........%%%.%.%.....%.....%.%.%...%
%%%%%%%%%%%%%%%.%%%.%.%%%.%%%.%.%.%.%%%
%.%.......%...%...%.%.%.%...%.....%...%
%.%%%%%%%.%%%.%.%%%.%.%.%%%%%%%.%%%%%.%
%%%%%%%%%.%.....%...%.%.......%.%.....%
%%%%%.%%%%%.%%%.%.%%%.%%%.%%%.%.%%%%%.%
%.......%...%.......%.....%.........%.%
%.%%%%%.%.%.%%%%%.%%%.%%%%%%%%%.%%%.%.%
%.%%%%%.%.%...%.%...%.....%.....%.%.%.%
%.%%%%%.%%%%%%%.%.%.%%%.%.%.%.%.%.%%%.%
%.%%%%%.%...%...%.%.%...%.%.%.%...%...%
%.%%%%%.%.%.%.%.%.%%%%%.%%%.%.%%%%%.%.%
%.........%...%.......%...%.%.....%.%.%
%%%%%%%%%%%%%%%%%%%%%%%%%%%%%%%%%%%%%%%
