%%%%%%%%%%%%%%%%%%%%%%%%%%%%%%%%%%%%%%%
%.....%...%.%...%.%.......%...........%
%%%%%.%.%%%.%%%.%.%%%%%%%.%%%%%.%.%%%.%
%.%...%.....%...........%.%.%...%.%...%
%.%.%.%.%%%%%%%.%%%%%%%.%.%.%.%%%.%.%%%
%.%.%.......%.%.%.....%.%.%...%...%...%
%.%.%.%%%%%%%.%.%.%%%.%%%.%%%.%.%.%%%%%
%...%.......%...%...%...%.%.%.%.%.....%
%%%.%%%.%%%%%.%%%.%%%%%%%.%.%%%%%.%.%%%
%.%.%...........%.%.%.....%.....%.%...%
%.%%%%%.%%%%%.%%%.%.%%%.%%%.%%%.%.%%%.%
%.%.%...%.%...%.....%.......%.%.%.%...%
%.%.%%%.%.%.%.%.%.%%%%%%%%%%%.%.%%%%%.%
%.........%.%...%.%.%...%...%...%.....%
%%%.%%%%%%%.%%%%%.%.%.%%%%%.%.%%%.%%%.%
%.........%.....%...%...%...%.....%.%.%
%%%%%.%.%.%%%.%%%%%%%%%.%.%%%.%.%%%.%.%
%.%.%.%.%.........%.%.........%...%.%.%
%.%.%.%%%%%%%.%.%%%.%.%%%%%%%.%%%.%.%.%
%.....%.%.%...%...%.%.%.%.%...%...%.%.%
%%%%%.%.%.%%%%%.%%%.%%%.%.%.%%%.%.%.%%%
%.%.%.......%.%.....%.%.....%.%.%...%.%
%.%.%%%.%%%%%.%.%.%%%.%.%%%%%.%%%%%.%.%
%...........%...%.%.......%.%.........%
%%%.%%%%%%%%%%%.%.%%%%%.%%%.%%%.%%%.%%%
%.%.....%.....%.%.%.....%.....%.%.%...%
%.%%%.%%%.%%%%%.%%%.%.%%%.%%%.%.%.%.%%%
%.%.......%...%...%.%.%.%...%.....%...%
%.%%%%%%%.%%%.%.%%%.%.%.%%%%%%%.%%%%%.%
%.....%.%.%.....%...%.%.......%.%.....%
%%%%%.%.%%%.%%%.%.%%%.%%%.%%%.%.%%%%%.%
%.......%...%.......%.....%.........%.%
%.%.%%%.%.%.%%%%%.%%%.%%%%%%%%%.%%%.%.%
%.%...%.%.%...%.%...%.....%.....%.%.%.%
%.%%%%%.%%%%%%%.%.%.%%%.%.%.%.%.%.%%%.%
%...%.%.%...%...%.%.%...%.%.%.%...%...%
%.%%%.%.%.%.%.%.%.%%%%%.%%%.%.%%%%%.%.%
%...%.....%...%.......%...%.%.....%.%.%
%%%%%%%%%%%%%%%%%%%%%%%%%%%%%%%%%%%%%%%
